WWWWWWWWWWWWWWWWWWW
WWWWW___WWWWWWWWWWW
WWWWWB__WWWWWWWWWWW
WWWWW__BWWWWWWWWWWW
WWW__B_B_WWWWWWWWWW
WWW_W_WW_WWWWWWWWWW
W___W_WW_WWWWW__OOW
W_B__B__________OOW
WWWWW_____WPWW__OOW
WWWWW_____WWWWWWWWW
WWWWWWWWWWWWWWWWWWW
