WWWWWWWW
WO_____W
W___BP_W
W______W
WWWWWWWW
