WWWWWWWW
W_____OW
W__P___W
W_PPP__W
W__P___W
W__W___W
WWWWWWWW
