WWWWWWWWWWWWWW
W________B__OW
WW___B____WWWW
WWWW_P__WWWWOW
W____B_______W
W____________W
W_O__________W
WWWWWWWWWWWWWW
